*********
*o***** *
*  *** x*
*   *   *
*       *
*********